00000000000000000000
00000000000000000000
00000000000000000000
00000000000000003000
00000000200000200000
00000000240004200000
00000101211101211111
00001000200000200000
00010000200000200000
30100000200000200000
10000000230000200000
00000001211101211311
00000400200000200000
00000100200000200000
30010000200000200000
11000000200003200000
00000010200001111003
00000000200000000011
00000000200000000000
00020000200000020000
40020003200000023000
11121001211101121100
00020000200000020001
00020000200000020000
00020000200000020000
30020000204003020040
11111101111101111111
#
PX=9
PY=24
S1X=3
S1Y=24
S2X=11
S2Y=4
S3X=17
S3Y=24
S4X=18
S4Y=4