00000000000000000000
00000000000000000000
00000000000000000000
00000000000020000000
00002000000023040000
00042344000021110043
00012111000020000011
00002000010320000000
00002000000111000000
00202000000000100000
30202002000000000000
11212102000000000000
00202002000000000000
00202002000000000000
00202002000020000000
30202002004020041003
11111102031121110001
00000002000020000000
00000000000020000000
00020000002020200000
30020302002023200000
11121102012111210000
00020002002000200000
00020002002000200000
00020002002000200000
30024442002004240040
11111111111101111011
#
PX=8
PY=24
S1X=2
S1Y=9
S2X=4
S2Y=14
S3X=2
S3Y=18
S4X=14
S4Y=14