00000000000000000000
00000000000000000000
00000000000000000000
00000000000000000000
00000000000002000000
00000000000002000000
00002000202002110043
00302004202002001011
00112101212102000000
00002000202002040030
00002000202002010320
03002030202002000120
11112110202002000020
00002000202002000020
00002000202042030020
00202000202011010020
04232000202000000020
11211110202000000011
00200000202000030100
00200000202000010000
00200004232000100020
00200001111010003020
00200000000000011121
00200000000000000020
00203000000000000020
04201100000004030020
11110011110111111111
#
PX=8
PY=24
S1X=1
S1Y=10
S2X=9
S2Y=6
S3X=17
S3Y=20