00000000000000000000
00000000000000000000
00000000000000000000
00000000000000000000
00002000020000000200
00002003020040030203
00002111121011111211
00002000020000000200
00002000020000000200
00202020020002000200
40202023024002000200
11211121121012111111
00200020020002000000
00200020020002000000
00200020020002000200
30200023020002000203
11210121111112101211
00200020000002000200
00200020000002000200
00200020020002000200
30203020020302004200
11211110121111101211
00200000020000000200
00200000020000000200
00200000020000000200
40240300020030040200
11111111111110111111
#
PX=9
PY=24
S1X=6
S1Y=4
S2X=1
S2Y=24